010200010201020000000200000100010000000200020001000001000002
010202010102010202000201020101020200000001000002020000000002
020201010002000102020202020100000002000002000000010000020002
010100000001020001000101000102000201010202000102000002010002
010201020102000001020201010000010102000200000102010001000001
020000020102010202010002010102010201000102020001020002000102
000001020000010200000001000002000201020002010101010002020100
020101010000000000000102020201010101000202000101000201020201
020001010102010202000102020200010100020100020000020000010101
010202020002010201010001000100020100000102020102000100000002
000202010202010000000201020002010101010001010202010001000202
010100010201010002020101010101020001000102010100000002000101
020102000202020201010202000101010002010101010202000000020100
000102010100020002020200000002020001020201000202010000020200
000202020201010101000201010102010201020100000000020102000002
000100020001020000020102020000000001000002020002020200010202
010100020101000102010202020101010101000002000201020001020200
000201000101000000020000010202000201000002020001020000010000
010201010100000101020100020102010100010201000101020002000102
020101000102000001010001010202020201020001020202020201000101
010100020200020200010202010200000101020002000001000201010202
010002020002000200010002010100020201000002000001000101010001
010001010101010002020201010101020000010000020200010201000100
020100000102000201000201010200000100000101010202020202000101
010000000102000102010002000200020101000100020201020100020102
000201010101000001020100010101020201000201020200020100000001
020002020100020201000200010102020001000202000200010101020000
000002020101020000010202020201010001000102020201020201000000
000102000000020100010102010201020200010000000100020100000200
000101010100020102000001000000010101010002010002010100020101
