020202020201010101010102020202020202020202010101010101010202020202020101010100000000000101010101010101010101010000000101010101010100000000000000010100000000000202020202020202020202
020202020101010101010202020202020202020202010101010101000202020202020101010100000000000001010101010101010101000000000101010101010100000000000000000000000002020202000101020202020202
020202010101010101010202020202020202020201010101010000000202020202010101010000000000020201010101010101010101000000010101010101010100000000000000000000000202020200000101010202020202
020101010101010101010102020202020202020201010101000000000002020202010101010000000002020202010102020202020200000001010101010101010100000000000000000002020202020201010101010101020202
010101010101010101010102020202020202020201010101000000000002020202010101010000000002020202020202020202020202000101010101010101010000000000000000000002020202020201010101010101010202
010101010101010101010101020202020202020202010100000000000202020202010101010100000000020202020202020202020202020201010101010101000000000000000000000002020202020101010101010101010202
000101010101010101010101020202020202020202020000000000020202020202020101010101010001010101010202020202020202020202020101010100000202000000000000000202020202020201010101010101010202
000001010101010000000101020202020202020202020101010100020202020202020201010101020202020101010102020202020202020202020101010000000002020000000000000202020202020201010101010101020202
000000010101000000000001020202020202020202020101010101020202020202020202020202020202020101010101020202020202020202020101010000000002020200000000000202020202020201010101000101020202
000000000100000000000001020202020202020202020101010101020202020202020202020202020202020201010101010102020202020202000101010000000000020201010101000002020202020202010100000002020202
000000000101000000000002020202020202020202020101010101020202020202020202020202020202020201010101010101010101000000000101010101010101010101010101000000020202020202010100000002020202
000202020201000000000001020202020202020202010101010101020202020202020202020202020202020101010101010101010101000000000101010101010101010101010101000000020202020201010101000002020202
020202020202010000000101010100010101010101010101010101020202020202020101010101010202020101010101010101020101000000000101010101010101010101010101000000000202020001010101010000020202
020202020201010101010101010101010101010101010101010102020202020202010101010101010202020101010101010102020202000000010101010101010101010101010100000000020202000000010101010101010202
020202010101010101010101010101010101010101010100000102020202020201010101010100000202020101010101020202020202020001010101000000010101010101010100000000020202020001010101010101010102
020101010101010101010101010101010101010101010100000101020202010101010101010100000202020101010202020202020202020001010100000000000101010101010100000002020202020001010101010101010101
010101010101010101010101010101010101010101010100000001010101010101010101010100000202020000000202020202020202020001010101010001010101010101010101000202020202020201010101010101010101
010101010101010101010101010101010101010101010000000001010101010101010101010000000202000000000002020202020202000001010101010101010101010101010102020202020202020202010101010101010101
010101010101010101010101010101010101010101010000000000000101010000000000000000000202000000000000020202020000000001010101010101010101010101020202020202020202020202010101010101010101
010101010101010101010102020201010101010101000000000000000000000000000000000000000000000000000000000000000000000002020202020101010101010102020202020202020202020201010101010101010101
010101010101010101010102020202020202020000000000000000000202000000000000000000000000000000000101010101010000000002020202020101010101020202020202020101010101020201010000000000000101
010101010101010101010102020202020202020200000000000000000202020000000000000000000000000000000101010101010100000002020202020201010202020202020202010101010101010101000000000202020202
010101010101010101010101020202020202020202000000000000000202020201000000000000000000000000000101010101010100000202020202020201020202020202020202010101010101010101000002020202020202
020101010101010101010101020202020202020202020000000000000202020202010101010000000000000000000000010101010101010202020202020201020202020202020202010101010101010101000202020202020202
020201010101010101010101010202020202020202020000000000000202020202020101010000000000020202000000000001010101010202020202020201020202020202020202010101010101010101020202020202020202
020201010101010101010101010102020202020202000000000000000002020202020200000000000000020202020000000000000001010202020202020200020202020202020202010101010101010100020202020202020101
020201010000010101010101010101020202020201010000000000000002020202020202000000000000020202020000000000000000010102020202020202020202020202020201010101010101010100000002020201010101
020201000000010101010101010101010202020201010100000000000002020202020202020000000000000002020000000000000000010101010202020202020202020202020101010101010101010100000001010101010101
020201000000010101010101010101010202020201010101000000010102020202020202020200000000000000000000000000000001010101010102020202020202000000000001010101010101000000000101010101010101
020202000001010101010101010101010202020202010101010101010202020202020202020202000000000000000000000202010101010101010101020202020202010000000000000000000000000000000101010101010101
020202020101010101010101010101010202020202020202020202020202020202020202020202000000000000000000020202010101010000010101020202020202010000000000000000000000000000000101010101010101
020202020201010101010101010102020202020202020202020202020202020202020202020202000000000000000000020202010101000000000101020202020202010000000000000000000000000000010101010101010101
020202020202010101010101010202020202020202020202020202020202020202020202020202000000000000020202020202010100000000000102020202020202010000000000000000000000000001010102020101010101
020202020202010101010101010202020202020202020202020202020202020202020202020202000000000002020202020202010100000000000002020202020202010000000000000000000000000101010202020101010101
020200000201010101010101010202020202020202020202020202020202020202020202020202020101010202020202020202000202020202020001020202020202010100000000000001010101010101020202010101010101
000000000001010101010101010202020101020202020202020202020202020202020202020202020201020202020202000202020202020202000000010102020202010100000000000000020201010101010101010101010101
000000000001010101010101010202010101010202020202020202020202020202020202020202020202020200000000000002020202020202000000000101010202010100000000000202020202020101010101010101010101
000001010101010101010101020202010101000002020202020202020202020202020202020202020201010100000000000202020202020200000000000001010102010100000000000202020202020201010101010101010101
010101010101010101010102020202020000000000020202020202020202020202020202020202020101010100000000020202020202020000000000000001010101010100000000000202020202020101010101010101010101
010101010101010202020202020202020200000000020202020202020202020202020202020202010101010000000002020202020202020000000000000000010101010101000000020202020202020101000000000000010101
010101010101020202020202020202020202020000020202020202020000020202020202020202010100000000020202020202020202020101000000000000010101010101010102020202020201010100000000000000010101
010101010102020202020202020202020202020202020202020202000000000202020202020202010000000002020202020202020202020101010000020200000101010101010202020202020101010100000000000000010101
010101010102020202020202020202020202020202020202020202000000000002020202020200000000000202020202020202020202020101010102020200000001010101020202020202010101010100000000000202010101
010101010202020202020202020200020202020202020202020200000000000000000202020000000000020202020202020202020202020101010202020200000000010102020202020202010101010101000000020202010101
010101010102020202020202020000000202020202020202000000000000000000000000000000000002020202020202020202020202020202020202020202000202020202020202020202010101010101000002020202010101
010101010102020202020202020100000202020202020101000000000000000000000000000000000002020202020202020202020101010202020202020202020202020202020202020201010101010101010102020202010101
010101010100020202020202020100000202020202010101000000000000000000000000000000000002020202020202000101010101010102020202020202020202020202020202020201010101010101010202020202020101
010101010000000202020202020202000000010101010101000000020000000000000000000000000002020202020202010101010101010000020202020202020202020202020202020201010101010101010202020202020101
000000000000000002020202020202020001010101010101000002020202000000000000000000000000020202020202010101010101000000020202020202020202020202020202020202020202020202020202020202020202
000000000000000000020202020202020101010101010202020202020202020000000000000000000000020202020202010101010101000000000202020202020202020202020202020202020202020202020202020202020202
020000000000000000020202020202010101010101020202020202020202020202000000000000000000020202020201010101010101000000000202020202020202020202020202020202020202020202020202020202020202
020000000000000000020202020202010101010101020202020202020202020202020000000000000002020202020201010101010101000000020202020202020202020202020202020202020202020202020202020202020202
020202010101000000000202020202000000000101020202020202020202020202020200000000000202020202020201010101010101000002020202020202020202000000020202020202020202020202020202020202020202
020202020201010000000202020202000000000001020202020202020202020202020202000002020202020202020201010101010101010002020202020202020200000000000202020202020202020202020202020202020202
020202020202020200000202020202000000000001020202020202020202020202020202020202020202020202020001010101010101010102020202020202020200000000000202020202020202020202020202020202020201
020202020202020202020202020201000000000202020202020202020202020202020202020202020000000000020000010101010101010102020202020202020000000000000002020202020202020202020202020202020101
020202020202020202020202020101000000020202010101020202020202020202020202020202000000000000000000000000000001010202020202020202000000000000000002020202020202020202020202020202020000
020202020202020202020202020101000202020201010101000002020202020202020202020202000000000000000000000000000000020202020202020200000000000000000202020202020202020202020202020202020000
020202020202020202020201010102020202020201010100000001020202020202020202020202020000000000000000000000000002020202020202020000000000000000000202020202020000010202020202020202000000
020202020202020201010101010102020202020000000000000001020202020202020202020202020000000000000000000000000002020202020202000000000000000000000202020202020200010101020201010101000000
020202020202020101010101010102020202000000000000000101010202020202020202020202020200000000000000000000000000020202020202000002020200000000000002020202020202010101010101010101010101
020202020202010101010101010102020202000000000000010101010102020202020202020202020202000000000000000000000000000202020200000202020202020000000000020202020202010101010101010101010101
020202020202010101010101010102020200000000000000010101010101020202020202020202020202020200000000000000000000000202020000000202020202020000000000000202020202010101010101010101010101
020202020202010101010101010102020200000000000002020101010101020202020202020202020202020202000000000002020202020200000000000202020202020101000101010102020201010101010101010101010101
010101010202020201010101010101000000000002020202020200010101020202020202020202020202020202000000000002020202020202000000020202020202020101010101010002020101010101010101010101020202
010101010102020202020201010101000000000202020202020200000001020202020202020202020202020202000000000002020202020202000000020202020202000000010101000002020001010101010101010202020202
010101010102020202020201010101000000000202020202020200000002020202020202020202020202020202000000000002020202020202020202020202020202000000000000000202020001010101010101010202020202
010101010102020202020201010100000000000000020202020202020202020202020202020202020202020202000000000000020202020202020000020202020202020000000000020202020101010101010101010202020202
010101010102020202020202010100000000000000000002020202020202020202000000020202020202020200000000000000020202020200000000000002020202020202000002020202000101010101010101010102020202
010101010102020202020202010100000000000000000002020202020202020201010000020202020202020100000000000000010202020000000000000002020202020202020202020200010101010101010101010102020202
000101010002020202020202020100000000000000000002020202020202020101010102020202020202010100000000000000010202000000000000000002020202020202020202020001010101010101010101010102020202
000000000002020202020202010000000000000000020202020200000000010101010002020202020201010101000202020000010101000000000000000000020202020202020200000000000000000101010101010102020202
000000000002020202020200010100000000000002020202020000000000000100000002020202020202010101020202020202020201000000000000010101020202020202020000000000000000000001010202020202020202
000000000202020202020000000100000000000202020202020000000000000000000002020202020202010101020202020202020202020101010101010101010202020202000000000000000000000001020202020202020202
000000000202020202020000000000000000000202020202020000000000000000000002020202020202020101010202020202020202020202010101010101010102020000000000000000000000000001020202020202020202
000000000202020202020200000000000000020202020202020000000000010100000002020202020202020101010101000202020202020202020101010101010101010101010000000101000000000000020202020202020202
010101010202020202020200000000000101020202020202000000010101010101000000020202020202010101010101010001020202020202020201010101010101010101010000010101010100000000020202020202020202
010101010102020202020200000000000102020202020202000101010101010101010101020202020202010101010101010101010202020202020201010101010101010102020100010101010100000000000202020202020202
010101010101020202020200000000010202020202020202010101010101010101010101010202020201010101010101010101010102020202020201010101010101020202020201010101010100000000000202020202020202
010101010101020202020200000001010202020202020202010101010101010101010101010202020201010101010101010101010101010101010101010101010101020202020201010101010100000000000202020201020202
000101010101010202020000000001020202020202020202020101010101010101010101010202020201010101010101010101010101010101010101010101010101020202020201010101010100000000010202020101010202
020101010101010202010100000102020202020202020202020101010101010101010101010102020202020000010101010101010101010101010000000101010101020202020101010101010100000101010202010101020202
020202010101010101010100000202020202020202020202020201010101010101010101010102020202020200010101010101010101010101000000000001010101020202020101010101010100010101010201010101020202
020202020202020101010101000202020202020202020202020202010101010101010101010102020202020200010101010101010101010101000000020202020202020202010101010101010001010101010101010101020202
020202020202020101010100000202020202020202020202020202010101010101010101010102020202020201010101010101010101010100000202020202020202020201010101010101010101010101010101010101020202
020202020202020101010100000101020202020202020202020202010101010101010101010102020202020202010101010101010100000000000202020202020202020000010101020202020201010102010101010101020202
020202020202020101010000000101010101010101020202020201010101010101010101020202020202020202020201010101000000000000000002020202020202000000010102020202020202020202020101010101020202
020202020202010100000000000101010101010101010102020201010101010101010102020202020202020202020202010100000000000000000002020202020200000000010102020202020202020202020101010101020202
020202020202010100000000000001010101010101010101010101000000000000000101020202020202020202020202020100000000000000000102020202020000000001010102020202020202020202020201010101010202
020202020202010101000000000001010101010101010101010100000000000000000001020202020202020202020202020100000000000000000102020202020000000001010101020202020202020202020101010101010202
