211002220101020021201001022111
122002020222102000022112102211
111102101101010212200012220010
112002202111110122011202102112
120120112211121011202010222220
201201021020020101220021000012
112222202202000100011002210011
211001122212210022012022120210
221002221101220210011222001121
202200022112020222110012211010
120200220112112200202211202200
102222202102000012212001212010
022212010210201011122002011220
100100212010122221122100222001
111210002101221010200222212011
100122111100002202211122000002
222211100202012001220111021211
211000001110101112110210210010
021101100011222120021021102200
220200210221110212210211002222
010121122111100101000020222222
120222221012011220001101001221
022101121010011111220201102020
212211211020121012112012210102
101101010121222120222220000101
012210102212022022201200021222
021001211211121012100022101010
111121021201222100122210100202
011222101102220002101220211222
222101120221020021012220020110
